............
............
..#########..
..#%%%%%%%#..
..#%%%%%%%#..
..#%%%%%%%#.
.@#%%%%%%%#$.
..#%%%%%%%#..
..#%%%%%%%#..
..#%%%%%%%#..
..#########..
............
............